████████████████████
█...█████..........█
█.╘.█...█.███....@.█
█...█.█.█...█......█
█████.█.███.████████
█.....█.....████████
█.███████████......█
█.█...█...□.█....▼.█
█...█.......║......█
████████████████████
