████████████████████
█...█..........█...█
█...║..........║.╘.█
█.▼.█..........█...█
█...█.....╘.██.█████
██████......█......█
█....████████......█
█.@................█
█....████████lvl2..█
████████████████████
