████████████████████
█...█.....█....█...█
█.........█....║.▼.█
█.╘.█..spooky..█...█
█...█.....████.█████
███████.....█......█
█....████████......█
█.@................█
█....████████......█
████████████████████
