████████████████████
██....†.†.†.†.█..███
█................@▲█
█†....†.†.†.†.....██
█...███████...██.███
█.....██████.....███
█...█...██████†...██
█.▼.███...███████.██
█████████.........██
████████████████████
