████████████████████
█...█████..........█
█.╘.█...█...█....@.█
█...█.█.█...█..†...█
█████.█.█...████████
█.....█.....████████
█.███████████.†....█
█.█████...□.█....▼.█
█...........║...†..█
████████████████████
