████████████████████
█...█.†..████..█...█
█........██....║.▼.█
█.╘.█.†..██.█..█...█
█...█....██.█..█████
███████.....█......█
█....████████....†.█
█.@................█
█....████████..†.†.█
████████████████████
