████████████████████
██.....║......█..███
████████...........█
█.................██
█...███████...██.███
█.....██████.....███
█...█...██████....██
█.▼.███...███████═██
█████████...║.....██
████████████████████
