████████████████████
█...█████..........█
█...█...█...█......█
█...█.█.█...█......█
█████.█.█...████████
█.....█.....████████
█.███████████......█
█.█████.....█....▼.█
█...........║......█
████████████████████
