████████████████████
█...█....████..█...█
█........██....║.▼.█
█...█....██.█..█...█
█...█....██.█..█████
███████.....█......█
█....████████......█
█..................█
█....████████......█
████████████████████
