████████████████████
██............█..███
█..................█
█.................██
█...███████...██.███
█.....██████.....███
█...█...██████....██
█.▼.███...███████.██
█████████.........██
████████████████████
