████████████████████
█........█.........█
█........║.......■.█
█........█.........█
█........██████═████
█..................█
█..................█
█████████..........█
█.......║..........█
█.......█..........█
████████████████████
