████████████████████
█........█.........█
█........║.......■.█
█........█.........█
█........██████═████
█..................█
█..................█
█..................█
█..................█
█..................█
████████████████████
