████████████████████
█........█.........█
█........║.......■.█
█........█.........█
█........███████████
█..................█
█..................█
█..................█
█..................█
█..................█
████████████████████
