████████████████████████████████████████████████████████
█..............█.......................................█
█..............█.......................................█
█..............█.......................................█
█..............█.......................................█
█████████████..██████████..............................█
█......................................................█
█......................................................█
█......................................................█
█......................................................█
█......................................................█
█......................................................█
█......................................................█
█......................................................█
█......................................................█
█......................................................█
█......................................................█
████████████████████████████████████████████████████████