████████████████████████████████████████████████████████
███............████████.....████████████████...........█
█.....■........███████████═██████████████..............█
███............║.....................███...............█
████...........█████████..█████████....................█
████████████████................████..................██
█..................................████...............██
█........................█████......████..............██
█......................█████████......███.████████...███
██.........███.......█████................█......█...███
███.......█████.....██....................█..........███
█████....██████....██.....................█......█...███
█.........████......██............█████████████████..███
██.████....███.......███........███....................█
███████.....█....██..█████....███.....██.███═███═███═███
█████████.▼....████....████████...██..█...█...█...█...██
██████████..███████████████████..████.█.■.█...█.■.█.■.██
████████████████████████████████████████████████████████
