████████████████████
██..■..║..█......███
█......█..██........
████████..███.....██
█....████........███
█.....█████...■..███
█...█...█████.....██
█.▼.███...███████.██
█████████.........██
████████████████████
